..##...#.....#.....#..##......##...#.....#.#...#...###.#...............#..........#............#
...###...#....##....#..#.........#...##.#...##.......#...#.....#....#......#.#............##....
......#..##..........#........##.........###..#.#....##....#.#.#...##.#..#.........#.#..#.....#.
....###.#..#....##........#....#.##....#..#..#.##..#.......#......##..####...#........#...#.##..
........##.#..#.......#.#.................#.#..##.......#.#.....#.....#..........#.....#........
...##.#.#......###...#...#...##..##...#..#.##.#..####..####.......#.......#...........#....#....
#....#..#.#.#..#.###...###..#####.#..#.#..#..#..##.#..#..#..#.#..........#......#.........##....
..#..#.......#..#..#.##..#.##.....#.......#.................#...........#.#.....#.......#...#.#.
##.......##.......#.............#...##....#..#.....#.....#...#..#......###....#.#.#...#....#....
.............#.........#..........#...#....#####...#.#...........#.........#.........##.#.......
.........#..#..#...#....#.#..##.......#.#........#..#.............#...#..#...#...#...##.........
....#.##..#.#..#.....##....#..#.........#.#..#..#....##.#.####...###.#..#.#..##...#........#.#..
.##.......##.#...#..#.#....#....#...##..#........#..#..#..#..#..#......#........#..#............
.#.......##........#...#.#...#..........##.....#.....#.............#.###.#....#....#....#.#.....
.......#.........#........#........#....#....#.#.....##.#.....#...#........##....#.#........#...
.........##..........#.###..#....#.#..........#####...##.....#.....###..#..#.......#..#.#.......
...#....##....##....###...###....##...#.#.#...#...#.......#...........#......#.......#.#.....#..
..#.#..##.#..#..#.##........#.#....#.###.#...#..#.....#....#........#...#...##......#...........
...#.............#.#...................#..........#........#...#.#....#.#.........##.#.#...#....
...#...#...##..............#....##....#..#.#...#.#...#.#.#....#..#...#.#......#.........###..#..
....##......#........#.#...#..#.............#....##....##....###...........###.####...........#.
.....###..#..##...#......#..#..........##....#..#..#..#.##.##......#..#..#..#....#...#...#...#..
#.#...........##.....#.....###...........................#.#...................#................
.................##...#.......##.##.....#........#..#.#..#...#......#........##.......#..#..##..
#....#.#.........#..#....#.#...#...#........#..........#....#...###...............#............#
#..#...........#......##.....##.##..#...#...#....#.........#.##........#...#..##..............#.
...............#..###........##..##.#..##.....##.#.#.#....#.....#......#....#...............##..
....#.###.........##.#..###....##..##.....#...........#......#........##..#....##....##.#..###..
.#.#.....#....#.#...#.......#..#..#.........#.......#...#..##.####...#..#..#.##..#.##..#..#...##
.......#....#.......###.....#.#......###..#.#....#.#.#.......#.#...#..#...#............##...#...
.#...#....###.##..##..###..##..#.........#.#..#.##.#..##.######......#.#..#.....###....#........
.....#..........#.#......#......#.....##....##.#.##..#..#..##....##..#....##..#..#........##..#.
.#.....#......#..##....#.#....#....##.#..#..#.....#.#....#.#.......#.....#.....#...###....##....
##....................##..##.#...#......#...##.#.##............#..#..#..#......#....#.##..##.##.
........##........#......#......##...#.....##...#.#...#..#.#.............#..#..#..##.......###..
######...#............#..#.......###.....#...#.#.#...#.#......##......#...#.##........#....#..##
#..#.....####.....#..##...###..................#......##..........#.#...##................#..#..
...#....#.........#....#.#............#...#........#........#..#...##....#..###...#.##...#...#..
..#..#.....#........###..........#..#.#.#...#.#.#.#.##......#...#.......#................#..#...
.##.....#.....#......#.##.#.#....#.....###.....#..#......#...#.......#..#.#...#...........#.....
......#.##...##...###.##.###....#.#..........#........#........#....###.....#..#.#.##.#...##....
##..#...##..##.#..#..#..#...........#.......#....#.....#......#....#.....##..........#........#.
.#.####....#...#...........#...........#....#..........#...#.....##......#.....#..........#.....
.........###....##......#.#.....#.#..#.##.#........#....##.#.....#.#...........#.......##.......
.#...###..#......##...#...#.#..#.....#........#.............#..#..#......#...............#...#..
#......#.#........#.................#......#....#.....##...#.......#...#..............#...#..#.#
......#.#.....#............##......#.#..........#................#.....##..............#.#....##
........#.#.........#..#..#.#.......#.#.##....#............##...##......#..#..#...#.....#...#...
.#...####...#.....##....#.#.#...........#.##.####.#..##.#.####.........#........................
......#.....#.#..........#.##..#...........#..##.#.##..#.##.....#......#.#.##.#.................
..#...#.##.....####.#...#....#....#....#..#....#........#.###...........#...#........###........
......#...........#..#..#...#.#.##.##...#.....#.#.#..#......................##............##.#..
.......#..##.##..................#...........#....#................#.#....#.....#...............
...........##..#..#..#..#.............#....##...#.......##....##.####....##....###.#.#.#.....#..
#...##..##..#.#.....#.###......#......#.........#...........#..##.#..#..#..#..#.#...#...#.....#.
.#..#..#..##.#.....#.#...#............#..#...##..#..........................#.##.#..##...#......
.####........##..#..#.#.....#..#..##..........#...........#.#..#...#..#.#..........#...#.#......
....##.#.##....###...###....#...#.............#..#.#.....................#...#.#................
.....#..#.##..#.##..#...#.#..........##....#....#....#.##........#.#.#.....#.#.#.....#.....#.#..
......#.....#.###.#.#.#.....#####.....#.#.#......#....#.....#.##.......#.....#..#......#...###..
...#.#....#....#.....#..#..#.......#....#.#.....#....#.#...####..#.#..#.#......##....#......#...
.##.#.....#...#...............#.#...........#..#..#.......####...............#.....#....#.##.#..
....#.#......#.#........#....#..#..#..#....#........##.#................#....#.......#.#...#.#..
#...#.#.....#....#..#...#.#.......#.....#..#........#......##.#...#.#.......##..#......##...#..#
...#......#..###....###..#.##....##..#.###...#..##.#......##......#..###.....#.#.........#......
........#......#..#.#..#..#.###.#..#.##.....#...##.#......#...#.#......#..#........#.....#.##...
........#..................#...........#.......#......#..#.#.......#.#...#.#.#..........#.......
.......................##...........#..#.#.#....#...##.....#.#....#...........#.##.#............
.#.......#...##..#.......#..##...........#....................#.....#..##.##....#.#....#........
...#.....#.....##.....#.....#...#.#..###..#.#..#...#..##........##......#..#.....#........#.....
.##..#......###.##.....##.#...###....##....###......#....##.......##.#..#..................#.#.#
..#...#......##..#........##..##.#..#.##..#..................#.....#..#.....#.#.#.....##...#..#.
..#...#.#...........#..............##.#.....#..#.......###........#..........#..#....#.....#....
....##......#....#.....#.....#.........#..##..#.......#..#...#.##..#.##..##.##....#.......#....#
.##...###..#.##..........#.........##........#.#........#..#.#....#...##................###..###
.....#...#..#..#..#.##.....#....#...#.#....##..##.....#....#...#..#....#............#.#...#.#...
.#..#..###.....#.......#.......#......#....#..............#...#.#...##.....#............#.......
..#.....##..#.....#..#.........#..#....#........#..##.....##.....#....#....#.....#.###....###...
....##.#.##...#.............##.#..##...........#...#......##....##....#...#............##......#
.#..#....#..#.....#.#......#.#...........#..##..###.#..#......#...#.#.#..#....#.....##.#.......#
.#.....##..#.....#...#....##....#.......##.....#.#....#..#..#....####..###...###.........#..#...
.#.#..#...###...##....##...#...#......#..#....##.#...#.#..#..#..####..####.##.#.#.......#......#
...#..#...............#.#....#.#.....#.##..#........#.......#..#.....#..................##......
......####...#.#......#......#...#..#.#.................#..#....#....#.#..#....###.....#....#.#.
..#.#..#...........#.#.......#...##...#......##....#.#..#..#....#...................#.#..#......
......#.....#....#......#..#..#.......##........#.#.##...............#.##..##.#...#.....#...#..#
#..........#.#.#..............#.#.....##...#........##..#.#....##.#..##....###...#........#.....
#.........#...#....#...#.#..#.....#..........##............##.#..#..##.##.#............#.......#
.#...##.....#.#.#.....#.........#......#...#..#....#.#...........###...........##...#.....##.#..
.##..#..##.#..#........#...#....#..#..........#..#.......##.......#..#.......#..#.....##...#....
#..#...#....##...#.##..#....#.##..#....#.....#.......#.....#...#...##......##..........#.#.##...
.......##....#...........##..###....#.....#...............#.#....#..##..#...#.#.#.#....##....#..
###.##.#.........#.#..#.#.##..#....#.#..#.#.....##...........#..#.#.##............##......#.#...
..#...#.#.............##...............#..#..#.##.#...#......#.....#..#..####.........#.........
......#.#..#.##..........#......#....#.....#..#.....#.........#..#...##.#.....#............##...
..#..#..#......#.....##..#.........#...#.................#......#......#.#....#.##........#..#..
